111111111
100000001
1P0C000E1
111111111
