111111111111111111
10000001100P0000E1
1C1000000000000001
100000011111111111
111110000000CC1111
100000000000000001
10000000C000011111
111111111111111111
